%%%%%%%%%%%%%%%%%%%%%%%%%%%%%%%%%%%%%
%  %%      %         %%%%%   %  %%  %
%  %     %  %%%%%%%%         %  %%  %
%     %%%            %%%%%%  %  %%  %
%        %%% % % % %%%%%%%%% %  %%  %
%    %%%       %%%%%%%%%%       %%  %
%       %%%     %%%%%%%%%%   %  %%  %
%   %  %   %%%    %%%%%%%%%%%%      %
%     %       %%%            %  %%  %
%     %%%%%%    %%%%%% %%%%% %  %%% %
%    %%%%   %%%   %%     %%%%%%%%  P%
%  %%%%%%  %%   %%%%  %%    %%%% %%%%
%      %%%  %% %%    %  %%  %       %
%%% %% %%%% %% %   %%%      %% %%%  %
%%%          %%% %% % %%       %    %
%%%%% %% %%%%    %%      %%%%%%%%%%%%
%    %%%  % %    %% % %%% %     %%  %
%%%% %     %% %%   %     %%%%%%    %%
% %% %%  %%   %% %%  % %%%%%   %%   %                                  
%     %%% %%  % %%%% %%%%    %%%%  %%            
%%%%%%% %  %%    %%   % % %%% %%% %%%
%  %%% %%%%%  %%%%  %%%%  %    %%   %  
% %% %%    %% %%  %  %%   %%% %%    %
%  % %% %%    %%%   %   %   %%    %%%
%%% %%%%   %   %%%  %  %%%%%% %%% %%%
% % %%%% %%% %%  %%% %   %% %%%  %  %
%   %%%%  %% %% %%   %     % %  %%  % 
% %% %%    %% %%  %  %%   %%% %%    %
% %% %%    %% %%  %  %%   %%% %%    %     
% %% %%    %% %%  %  %%   %%% %%    %                       
%.%% %%    %% %%  %  %%   %%% %%    %           
% %%       %% %%   %     %%%%%%    %%
% %% %%  %%   %% %%  % %%%%%   %%   %                                  
%     %%% %%  % %%%% %%%%    %%%%  %%            
%%%%%%% %  %%    %%   % % %%% %%% %%%
%%%%%%%%%%%%%%%%%%%%%%%%%%%%%%%%%%%%%
