%%%%%%%%%%%%%%%%%%%%%%%%%%%%%%%%%%%%%
%       % % %           %   %     % %
% %%%%%%% % %%% % %%% %%% %%%%%%% % %
%   %   %       % %     %     % %   %
%%%%% %%%%% %%% % % % %%% %%%%% % %%%
%   % % % %   % % % %   % %   % %   %
% %%% % % %%%%% %%%%% %%% % %%% %%% %
%       %     %   %   %     % % %  %%
%%% %%%%% %%% %%%%% % %%% %%% % % % %
%   %         %     % % %   %   % % %
% % %%%%% % %%% % % %%% % %%% %%% % %
% % % %   % % % % %     %   % % % % %
% % % %%% %%% % %%%% %%%% %%% % %%% %
% % % %     %   %     %     %   %   %
%%% %%% % %%%%% %%%%% %%% %%% %%%%% %
%     % % %     % %     % %   % % % %
% % % % % %%% %%% %%% %%% % % % % % %
% % % % %                 % % %     %
%%% %%%%%%% % % %%%% %%%% % %%% %%%%%
%       % % % %     %   %     % %   %
%%%%% % % %%%%%%%%% %%%%%%%%%%% % %%%
%   % %           % %     %   % %   %
% %%% %%%%% %%%% %%%% %%%%% % % %%% %
% %   %               %     %      P%
% % % %%%%% %%% % % % % %%%%%%%%%%%%%
% % %   %     % % % %       %   % %%%
% % %%% %%% % % % %%%%% %%% %%% % % %
% %   % %   % % %   % %   % % %     %
% %%% %%% %%%%% %%% % % %%%%% % %%%%%
%       %   %     % %     %   % %   %
%%% % %%%%%%%%%%% %%% %%% % %%% % %%%
% % % % % % % %     % %   % %   % % %
% % %%% % % % % %%%%%%%%% % % % % % %
%       %   %                 %     %
% % % % %%% %%% %%%%%%% %%% %%% %%% %
%.% % %       %   %       %   % %   %
%%%%%%%%%%%%%%%%%%%%%%%%%%%%%%%%%%%%%
