%%%%%%%%%%%%%%%%%%%%
%%     %%  %%      %
% % % %%%  %%%%%%% %
% %  %        %%%% %
% %% % %%%%%% % %% %
%.     %%%        P%
%%%%%%%%%%%%%%%%%%%%
