%%%%%%%%%%%%%	    
%          P%
% %%%   %%% %
%         % %
% %%%   %%% %      
%.          %
%%%%%%%%%%%%%