%%%%%%%%%%%%%%%%%%%%%%%%%%
%                       P%
%%%%%%    %  %%%%  %     %
%      %%%%%%%  % %% %%%%%
%%%%%%             % %%% %
%.       %%%%%%%%%       %
%%%%%%%%%%%%%%%%%%%%%%%%%%