%%%%%%%%%%%%%%%%%%%%%%%%%%%%%%%%%%%%
%                                 P%
%%%%%%      %       %%%% %% %      %
%      %%%%%% %%%%% %    %% %% %%%%%
%%%%%%%%%%                  %%%%%% %
%.         %%%%%%%%%%%%%%%%        %
%%%%%%%%%%%%%%%%%%%%%%%%%%%%%%%%%%%%