%%%%%%%%%%%	    
%        P%
% %% % %% %
%  %%%%%  %
% %% % %% %      
%.        %
%%%%%%%%%%%